{
  "name": "Level 4",
  "description": "Level 4 Description",
  "currentFloor": 0,
  "width": 5,
  "height": 5,
  "floors": [
    {
      "name": "Floor 1",
      "map": [
        ["#","#","#","#","#","#","#","#","#","#","#"],
        ["#",".",".",".",".",".",".",".",".",".","#"],
        ["#",".","b","b","b","b","b","b","b",".","#"],
        ["#",".","b","-","-","-","-","-","b",".","#"],
        ["#",".","b","-","b","b","b","-","b",".","#"],
        ["#",".","b","-","b","@","b","-","b",".","#"],
        ["#",".","b","-","b","b","b","-","b",".","#"],
        ["#",".","b","-","-","-","-","-","b",".","#"],
        ["#",".","b","b","b","b","b","b","b",".","#"],
        ["#",".",".",".",".",".",".",".",".",".","#"],
        ["#","#","#","#","#","#","#","#","#","#","#"]
      ]
    }
  ]
}
