{
  "name": "Level 3",
  "description": "Level 3 Desciption",
  "difficulty": 0,
  "currentFloor": 0,
  "width": 8,
  "height": 10,
  "floors": [

    {
      "name": "Floor 1",
      "map": [
        ["1","1","1","1","1","1","1","1"],
        ["1","l","l","1","1","1","1","1"],
        ["1","l","l","1","1","1","1","1"],
        ["1","-","-","-","1","-","-","1"],
        ["1","-","-","-","1","b","-","1"],
        ["1","-","-","-","-","b","-","1"],
        ["1","-","-","-","1","b",".","1"],
        ["1","-","-","-","1","@","-","1"],
        ["1","1","1","1","1","-","-","1"],
        [" "," "," "," ","1","1","1","1"]
      ]
    },

    {
      "name": "Floor 2",
      "map": [
        ["1","1","1","1","1","1","1","1"],
        ["1","l","l","1","1","1","1","1"],
        ["1","l","l","1","1","1","1","1"],
        ["1","-","-","-","1","-","-","1"],
        ["1","-","-","-","1","-","-","1"],
        ["1","-","-","-","-","-",".","1"],
        ["1","-","-","-","1","-","-","1"],
        ["1","-","-","-","1","-","-","1"],
        ["1","1","1","1","1","-","-","1"],
        [" "," "," "," ","1","1","1","1"]
      ]
    },

    {
      "name": "Floor 3",
      "map": [
        ["1","1","1","1","1","1","1","1"],
        ["1","l","l","-","1","1","1","1"],
        ["1","l","l","-","1","1","1","1"],
        ["1","-","-","-","1","-","-","1"],
        ["1","-","-","-","1","-","-","1"],
        ["1","-","-","-","-","-",".","1"],
        ["1","-","-","-","1","-","-","1"],
        ["1","-","-","-","1","-","-","1"],
        ["1","-","-","-","1","-","-","1"],
        ["1","1","1","1","1","1","1","1"]
      ]
    }
  ]
}
