{
  "id": 6,
  "world": "World1",
  "name": "Level 6",
  "description": "Level 6 Description",
  "difficulty": "hard",
  "currentFloor": 0,
  "width": 37,
  "height": 22,
  "moves": 8,
  "solver": "ltttrtll",
  "floors": [
    {
      "name": "Floor 1",
      "map": [
        [" "," "," "," "," "," "," "," "," "," "," "," "," "," "," "," "," "," ","1","1"," "," "," "," "," "," "," "," "," "," "," "," "," "," "," "," "," "," "],
        [" "," "," "," "," "," "," "," "," "," "," "," "," "," "," "," "," ","1","1","1","1"," "," "," "," "," "," "," "," "," "," "," "," "," "," "," "," "," "],
        [" "," "," "," "," "," "," "," "," "," "," "," "," "," "," "," ","1",".",".",".",".","1"," "," "," "," "," "," "," "," "," "," "," "," "," "," "," "," "],
        [" "," "," "," "," "," "," "," "," "," "," "," "," "," "," "," ","1",".",".",".",".","1"," "," "," "," "," "," "," "," "," "," "," "," "," "," "," "," "],
        [" "," "," "," "," "," "," "," "," "," "," "," "," "," "," "," ","1","1","b","b","1","1"," "," "," "," "," "," "," "," "," "," "," "," "," "," "," "," "],
        [" "," "," "," "," "," "," "," "," "," "," "," ","1"," "," "," ","1","1","-","-","1","1"," "," "," ","1"," "," "," "," "," "," "," "," "," "," "," "," "],
        [" "," "," "," "," "," "," "," "," "," "," ","1","2","1"," "," ","1","-","-","-","1","1"," "," ","1","2","1"," "," "," "," "," "," "," "," "," "," "," "],
        [" "," "," "," "," "," "," "," "," ","1","1","1","2","1","1","1","1","1","-","-","1","1","1","1","1","2","1","1","1"," "," "," "," "," "," "," "," "," "],
        [" "," "," "," "," "," "," ","1","1","1","1","-","-","-","-","1","1","1","-","-","1","1","1","-","-","-","-","1","1","1","1"," "," "," "," "," "," "," "],
        [" "," "," "," "," ","1","1","1","1","-","-","-","-","-","-","-","-","b","b","b","b","-","-","-","-","-","-","-","-","1","1","1","1"," "," "," "," "," "],
        [" "," ","1","1","1",".",".","1","1","-","-","-","-","-","-","1","1","b","-","-","b","1","1","-","-","-","-","-","-","1","1",".",".","1","1","1"," "," "],
        [" ","1",".",".","-","-","-","-","-","-","-","-","-","-","1","1","1","-","-","-","-","1","1","1","-","-","-","-","-","-","-","-","-","-",".",".","1"," "],
        ["1","1","1","1","1","-","-","1","1","1","1","1","1","1","1","1","1","-","-","-","-","1","1","1","1","1","1","1","1","1","1","-","-","1","1","1","1","1"],
        [" "," "," "," "," ","1","1"," "," "," "," "," "," "," "," ","1","1","-","-","-","-","1","1"," "," "," "," "," "," "," "," ","1","1"," "," "," "," "," "],
        [" "," "," "," "," "," "," "," "," "," "," "," "," "," "," "," ","1","b","-","-","b","1"," "," "," "," "," "," "," "," "," "," "," "," "," "," "," "," "],
        [" "," "," "," "," "," "," "," "," "," "," "," "," "," "," "," ","1","-","-","-","-","1"," "," "," "," "," "," "," "," "," "," "," "," "," "," "," "," "],
        [" "," "," "," "," "," "," "," "," "," "," "," "," "," "," "," ","1","1","-","-","1","1"," "," "," "," "," "," "," "," "," "," "," "," "," "," "," "," "],
        [" "," "," "," "," "," "," "," "," "," "," "," "," "," "," "," ","1","1","b","b","1","1"," "," "," "," "," "," "," "," "," "," "," "," "," "," "," "," "],
        [" "," "," "," "," "," "," "," "," "," "," "," "," "," "," "," "," ","1","-","-","1"," "," "," "," "," "," "," "," "," "," "," "," "," "," "," "," "," "],
        [" "," "," "," "," "," "," "," "," "," "," "," "," ","1","1","1","1","-","-","-","-","1","1","1","1"," "," "," "," "," "," "," "," "," "," "," "," "," "],
        [" "," "," "," "," "," "," "," "," "," "," "," ","1",".","-","-","-","-","-","-","-","-","-","-",".","1"," "," "," "," "," "," "," "," "," "," "," "," "],
        [" "," "," "," "," "," "," "," "," "," "," ","1",".","-","-","-","1","-","-","@","-","1","-","-","-",".","1"," "," "," "," "," "," "," "," "," "," "," "],
        [" "," "," "," "," "," "," "," "," "," ","1","1","1","1","1","1","1","1","1","1","1","1","1","1","1","1","1","1"," "," "," "," "," "," "," "," "," "," "],
        [" "," "," "," "," "," "," "," "," "," "," "," "," "," "," "," "," ","1","1","1","1"," "," "," "," "," "," "," "," "," "," "," "," "," "," "," "," "," "],
        [" "," "," "," "," "," "," "," "," "," "," "," "," "," "," "," "," "," ","1","1"," "," "," "," "," "," "," "," "," "," "," "," "," "," "," "," "," "," "]
      ]
    }
  ]
}
