{
  "id": 3,
  "world": "World1",
  "name": "Level 4",
  "description": "Level 4 Description",
  "difficulty": "hard",
  "currentFloor": 0,
  "width": 10,
  "height": 10,
  "moves": 8,
  "solver": "ltttrtll",
  "floors": [
    {
      "name": "Floor 1",
      "map": [
        ["1","1","1","1","1","1","1","1","1","1","1"],
        ["1",".",".",".",".",".",".",".",".",".","1"],
        ["1",".","b","b","b","b","b","b","b",".","1"],
        ["1",".","b","-","-","-","-","-","b",".","1"],
        ["1",".","b","-","b","b","b","-","b",".","1"],
        ["1",".","b","-","b","@","b","-","b",".","1"],
        ["1",".","b","-","b","b","b","-","b",".","1"],
        ["1",".","b","-","-","-","-","-","b",".","1"],
        ["1",".","b","b","b","b","b","b","b",".","1"],
        ["1",".",".",".",".",".",".",".",".",".","1"],
        ["1","1","1","1","1","1","1","1","1","1","1"]
      ]
    }
  ]
}
